#########################################
#.......#...#.....#.........#...........#
#.###.###.#.#.###.#.#####.#.###########.#
#.#...#...#...#.#.......#.#.#...#.......#
#.#.###.#######.#########.#.#.#.#.#####.#
#.#.#...#...#.......#.....#...#.#.#...#.#
#.#.#.###.#.#.#.#####.#.#######.#.#.#.#.#
#.#.#...#.#...#.....#.#.#...#.....#.#...#
#.#.###.###########.#.###.#.#######.#####
#O#...#.#.........#.#.....#...#.#...#...#
###.#.#.#.#######.#.#########.#.#.###.###
#...#.#...#.....#.#.....#.....#.#.#.....#
#.###.#####.###.#.###.###.#####.#.#####.#
#...#.#.......#.#...#...#.#.....#.#.....#
###.#.#.#####.#####.###.#.###.###.#.#####
#...#.#.#...#...........#...#.....#.....#
#.#####.#.#############.###.###.###.###.#
#.........#...#.....#.....#...#.#.....#.#
#######.###.#.#.###.#########.#.#####.#.#
#.....#.#...#...#.............#...#...#.#
#.###.###.#####.#################.#####.#
#.#.#.#...#...#.#.....#.....#...#.#.....#
#.#.#.#.#.#.#.###.#####.###.#.#.#.#.#####
#.#.....#.#.#.....#.....#.#.#.#...#.....#
#.#######.#.#######.#####.#.#.#####.###.#
#.......#.#.#...#.....#.....#.#...#...#.#
#######.###.#.###.###.#######.#.#.#####.#
#.....#.#...#.#...#.#...#.....#.#.....#.#
#.#.###.#.###.#.###.###.#.#####.#####.#.#
#.#...#...#...........#.#.......#.#...#.#
#.###.#####.###########.#########.#.###.#
#...#.....#...#.#.....#.......#.....#...#
###.###.#.###.#.#.###.#.#######.#####.###
#.#.#...#...#...#...#...#.....#...#.....#
#.#.#.#########.###.###.#.###.###.#####.#
#...#.........#.#...#...#.#.#.....#...#.#
#.## ########.#.#.###.###.#.#######.#.#.#
#...#.......#...#...#...#...#...#...#.#.#
###.###.###.#######.#######.#.#.#.###.#.#
#.......#.........#...........#...#.....#
#########################################